21
15
22 4 0 0 0 0 0 0 0 0 0 0 0 0 0 0 0 0 0 3 22 
22 4 0 0 0 0 0 0 0 0 0 0 0 0 0 0 0 0 0 3 22 
22 4 0 0 0 0 0 0 0 0 0 0 0 0 0 0 0 0 0 3 22 
22 4 0 0 0 0 0 0 0 0 0 0 0 0 0 0 0 0 0 3 22 
22 4 0 0 0 0 0 0 0 0 0 0 0 0 0 0 0 0 0 3 22 
22 4 11 0 9 0 0 0 0 0 0 0 0 0 0 0 0 9 10 3 22 
5 24 24 24 25 0 0 0 0 0 0 0 0 0 0 0 23 24 24 24 6 
22 4 0 0 0 0 0 0 9 0 10 0 11 0 0 0 0 0 0 3 22 
22 4 0 0 0 0 0 0 23 24 24 24 25 0 0 0 0 0 0 3 22 
22 4 0 0 0 0 0 0 0 0 0 0 0 0 0 0 0 0 0 3 22 
22 4 0 0 0 0 0 0 0 0 0 0 0 0 0 0 0 0 0 3 22 
22 4 0 0 0 0 0 0 0 0 0 0 0 0 0 0 0 0 0 3 22 
22 9 10 9 11 29 10 9 11 10 9 11 10 9 11 10 9 11 9 3 22 
5 21 21 21 21 21 21 21 21 21 21 21 21 21 21 21 21 21 21 21 6 
0 0 0 0 0 0 0 0 0 0 0 0 0 0 0 0 0 0 0 0 0 
